SO		./textures/text3.xpm
NO		./textures/text3.xpm
EA		./textures/text3.xpm
WE		./textures/text3.xpm

F		100,100,80
C		0,30,80
111111111111111111
100000000000000111
100000000000000001
100000000000000000111111
100E00000000000000000001
100000000000000000000001
111111111111111111111111

a