NO		./textures/text3.xpm
SO	s	./textures/text3.xpm
EA		./textures/text3.xpm
WE		./textures/text3.xpm

F		25,100,200
C		255,250,25

11111
10001
10101
10001
100011111
10W01
11001
10001
10001
10001
10001
10001
11111