F		24,14,42
NO		./textures/text3.xpm
SO		./textures/text3.xpm
EA		./textures/text3.xpm
WE		./textures/text3.xpm


C		255,250,25

    11111
    10001
    101011111
    111110001
    10001111111111111111111111111111111111111111
    10W01
    11001
    10001
    10001
    10001
    10001
    10001
    10111


    101
    101
    101
    111